13
5
0 2 0 2 1
1 1 0 2 1
1 1 3 1 3
1 3 0 1 3
1 5 1 3 1
8
0 2 1 2 1
1 0 0 2 1
1 0 3 1 3
1 0 5 1 3
1 1 0 1 3
1 2 4 1 2
1 4 4 2 1
1 5 3 3 1
11
0 2 0 2 1
1 0 1 1 2
1 0 2 1 2
1 0 3 3 1
1 1 3 3 1
1 2 2 1 2
1 2 3 1 3
1 2 5 1 2
1 3 0 1 2
1 4 5 1 2
1 5 0 2 1
12
0 2 0 2 1
1 0 1 1 2
1 0 2 2 1
1 0 4 1 2
1 0 5 1 2
1 1 2 1 2
1 1 3 1 3
1 3 1 2 1
1 3 4 2 1
1 4 3 2 1
1 4 5 1 2
1 5 2 2 1
11
0 2 2 2 1
1 0 3 1 2
1 0 4 2 1
1 1 0 3 1
1 1 4 1 2
1 2 0 1 2
1 2 5 1 3
1 3 1 2 1
1 3 3 2 1
1 4 0 2 1
1 5 4 2 1
10
0 2 0 2 1
1 0 1 1 2
1 0 2 2 1
1 0 4 2 1
1 1 2 1 3
1 1 3 3 1
1 2 3 1 2
1 3 4 2 1
1 4 0 1 2
1 5 2 3 1
9
0 2 2 2 1
1 0 0 1 2
1 0 1 1 3
1 0 3 2 1
1 1 4 1 3
1 3 0 2 1
1 3 2 1 2
1 4 3 2 1
1 5 3 3 1
10
0 2 0 2 1
1 0 0 2 1
1 0 3 1 2
1 0 4 2 1
1 1 0 2 1
1 1 4 1 2
1 3 1 1 2
1 4 2 1 2
1 4 3 3 1
1 5 0 2 1
10
0 2 0 2 1
1 0 0 3 1
1 0 3 1 2
1 0 4 1 2
1 1 2 1 3
1 3 1 1 3
1 3 3 3 1
1 4 2 3 1
1 4 5 1 2
1 5 2 3 1
11
0 2 3 2 1
1 0 5 1 2
1 1 0 2 1
1 1 2 2 1
1 2 0 1 2
1 2 2 1 2
1 2 5 1 2
1 3 3 1 2
1 4 2 1 2
1 4 4 2 1
1 5 4 2 1
10
0 2 0 2 1
1 0 0 1 2
1 0 1 2 1
1 1 1 2 1
1 1 4 1 3
1 1 5 1 2
1 2 2 1 2
1 3 1 1 2
1 3 5 1 2
1 4 2 3 1
10
0 2 2 2 1
1 0 1 1 2
1 0 2 1 2
1 1 3 2 1
1 1 5 1 2
1 2 4 1 2
1 3 1 2 1
1 4 0 3 1
1 4 4 1 2
1 5 0 3 1
13
0 2 3 2 1
1 0 0 2 1
1 0 2 1 3
1 0 4 2 1
1 1 0 2 1
1 1 5 1 3
1 2 0 1 2
1 3 1 2 1
1 3 3 2 1
1 4 3 1 2
1 4 4 2 1
1 5 0 2 1
1 5 4 2 1